1111111111111
10010000E0001
1000011111001
1P001100000C1
1111111111111